*******************************************************************
               ***********************************              ***
************** ***                             *** ************ * *
***      ***** *** *************************** *** ************ * *
*** **** ***** *** **                          *** **       *** * *
*** **** ***** *** *********** *** *************** ** ***** *** * *
*** ****       ***    ******** *** *** *********** ** ***** *** * *
*** *****************      *** *** *** **          ** ***** *** * *
*** ********************** ******* *** ** ******** ** ***** *** * *
*** ***             ****** *    ** *** ** ******** ** ***** *** * *
*** *** *********** ****** * ** ** *** ** ******** ** ***** *** * *
*** *************** ****** * ** ** *** ** ******** ** *****     * *
***                  ***** * ** ** *** ** ******** ** ******* *** *
************** *********** * ** ** *** ** ******** ** ******* *** *
************** *********** * ** ** ***          ** ** ****    *** *
*****          *********** * **    ************ ** ** *********** *
***** ******************** * ****************** ** **      ****** *
***** ******************** * ********************* *******        *
*****                      *                       ******* ********
********************************************************** ********
